
******************************************************
*******                                       ********
*******  Readme: MIS Quarterly Export Filter  ********
*******                                       ******** 
*******           for JabRef                  ********
*******                                       ********
*******           version 1.0                 ********
*******            2007-06-12                 ********
*******                                       ******** 
******************************************************

Written by Matthias Stürmer - mstuermer[at]ethz.ch